R 600 400

NO    greystone.xpm

SO bluestone.xpm

WE bluestone.xpm

EA bluestone.xpm

S pillar.xpm

F 255,0,0

C 117,214,255
            11111111111111111111111111111111
            10000000000000000000000000000001
            10000000000000000000000000000001
            10000000000000000000000000000001
11111111111110000000000000000000000000000001
10000000000000000000000000000000000000000001
10000000000000000000000000000000000000000001
10000000000000000000W00000000000000000000001
11111111111111111111111111111111111111111111
